GACGTC	AatII
GGTACC	Acc65I
AACGTT	AclI
AGCGCT	AfeI
CTTAAG	AflII
ACCGGT	AgeI
GGGCCC	ApaI
GTGCAC	ApaLI
ATTAAT	AseI
CCTAGG	AvrII
GGATCC	BamHI
TGATCA	BclI
AGATCT	BglII
GCTAGC	BmtI
CGTACG	BsiWI
TCCGGA	BspEI
TCATGA	BspHI
TGTACA	BsrGI
GCGCGC	BssHII
TTCGAA	BstBI
GTATAC	BstZ17I
ATCGAT	ClaI
TTTAAA	DraI
CGGCCG	EagI
GAGCTC	Eco53kI
GAATTC	EcoRI
GATATC	EcoRV
TGCGCA	FspI
AAGCTT	HindIII
GTTAAC	HpaI
GGCGCC	KasI
GGTACC	KpnI
CAATTG	MfeI
GCGGCCGC	NotI
GCGATCGC	AsiSI
TTAATTAA	PacI
CCTGCAGG	SbfI
ATTTAAAT	SwaI
ACGCGT	MluI
TGGCCA	MscI
GCCGGC	NaeI
GGCGCC	NarI
CCATGG	NcoI
CATATG	NdeI
GCCGGC	NgoMIV
GCTAGC	NheI
TCGCGA	NruI
ATGCAT	NsiI
ACATGT	PciI
GGCGCC	PluTI
CACGTG	PmlI
TTATAA	PsiI-v2
GGGCCC	PspOMI
CTGCAG	PstI
CGATCG	PvuI
CAGCTG	PvuII
GAGCTC	SacI
CCGCGG	SacII
GTCGAC	SalI
AGTACT	ScaI
GGCGCC	SfoI
CCCGGG	SmaI
TACGTA	SnaBI
ACTAGT	SpeI
GCATGC	SphI
AATATT	SspI
AGGCCT	StuI
TCTAGA	XbaI
CTCGAG	XhoI
CCCGGG	XmaI
GACGTC	ZraI
GGCGCGCC	AscI
GGCCGGCC	FseI
GTTTAAAC	PmeI
GCCCGGGC	SrfI
